ステータス番号,スプライト,曲がり角か,曲がる方向
101,0,0,0
102,0,1,4
103,0,2,0
104,0,0,0
105,0,1,1
