ステータス番号,スプライト,曲がり角か,曲がる方向
101,0,0,0
102,1,1,4
103,1,2,0
104,1,0,0
105,1,1,1
