0,0,0,0,0,0,0,0,0,0,0,0,0,0,0,0,0,0,0,0,0
0,1,101,101,101,1,0,0,0,0,0,0,0,0,0,0,0,0,0,0,0
0,1,101,101,101,1,0,0,0,0,0,0,0,0,0,0,0,0,0,0,0
0,1,101,101,101,1,0,0,0,0,0,0,0,0,0,0,0,0,0,0,0
0,1,101,101,101,1,0,0,0,0,0,0,0,0,0,0,0,0,0,0,0
0,1,101,101,101,1,0,0,0,0,0,0,0,0,0,0,0,0,0,0,0
0,1,101,101,101,1,0,0,0,0,0,0,0,0,0,0,0,0,0,0,0
0,1,101,101,101,1,0,0,0,0,0,0,0,0,0,0,0,0,0,0,0
0,1,101,101,101,1,0,0,0,0,0,0,0,0,0,0,0,0,0,0,0
0,1,101,101,101,1,1,1,1,1,1,1,1,1,1,1,1,1,1,0,0
0,1,101,101,101,101,101,101,101,101,101,101,101,101,101,102,104,103,2,0,0
0,1,101,101,101,101,101,101,101,101,101,101,101,101,101,103,104,104,1,0,0
0,1,1,1,1,1,1,1,1,1,1,1,1,1,1,101,101,101,1,0,0
0,0,0,0,0,0,0,0,0,0,0,0,0,0,2,101,101,101,1,0,0
0,0,0,0,0,0,0,0,0,0,0,0,0,0,1,101,101,101,1,0,0
0,0,0,0,0,0,0,0,0,0,0,0,0,0,1,101,101,101,1,0,0
0,0,0,0,0,0,0,0,0,0,0,0,0,0,1,101,101,101,1,0,0
0,0,0,0,0,0,0,0,0,0,0,0,0,0,1,101,101,101,1,0,0
